0455555m...................
0c..............п..........
0c..........й.о.79.........
0x23.b......qrs............
000c.v..79..........дbf....
000c................qбs....
000x23...........и.........
00000c..........qs.........
00000c.......z...........н.
00000cy.@........п...ё..122
00000x222223....d23..122p00
00000000000c..12p0c..a00000