0455555m...................
0c..............пш.........
0c&.........й.о.79.........
0x3..qs.....qrs............
00c......79.........дbf....
00c.................qбs....
00x223...........и.........
00000c..........qs.........
00000c......79...........н.
00000cy.@........п...ё..122
00000x222223...ш123..122p00
00000000000c..12p0c..a00000