00c.....................
00c.....................
00c....й.о..............
00c....qrs..............
00c.............иbf.....
00c.............qбs.....
00c..........в..........
00c..........qs.........
00c.......z...........н.
00cy.@............ё..122
00x222223....d23..122p00
00000000c..12p0c..a00000