...............................
...............................
.....s.........................
.s............f.w..s...........
.w........w..w......gg.........
....w...............bb.........
tt......w..h...................
bb.............................
bbs...w........s.w..s..........
bb...s......g........g........g
bbgggttgggg.b.gtg.gggbggggg..gb
bbbbbbbbbbb.b.bbb.bbbbbbbbbbbbb