00c.....................
00c.....................
00c....й.о..............
00c....qrs..............
00c..............дbf....
00c..............qбs....
00c...........и.........
00c.......ш...qs........
00c.......z...........н.
00c&.@..ш.....п...ё..122
00x222223....d23..122p00
00000000c..12p0c..a00000