bbc.....................
bbc.....................
bbc.....................
bbc.....................
bbc.....................
bbc.......789...........
bbc...........qs........
bbc........z............
bbc..................122
bbx222223....d23..12pbbb
bbbbbbbbc..12pbc..abbbbb